5
Box0.sob
Goal.sob
Door.SOB
Switch.SOB
Unstable_Wall.SOB

8 8

1 0 0 1 0 1 0 0
1 1 0 1 0 0 1 0
1 0 0 0 1 0 0 1
0 0 1 0 1 2 0 0
0 5 0 0 5 5 1 1
1 0 0 1 1 1 0 0
0 0 0 0 0 1 1 0
1 1 0 0 1 0 3 0
