3
Box0.sob
Goal.sob
Door.SOB

8 1 8

1 1 0 1 0 1 0 1
1 0 0 0 0 0 1 0
1 0 1 0 1 3 0 0
1 0 0 1 0 0 1 0
0 1 0 0 1 0 0 1
0 0 0 1 0 1 0 1
0 1 0 0 0 0 0 0
1 0 0 1 1 0 1 0