4
Box0.sob
Goal.sob
Door.SOB
Switch.SOB

8 1 8

0 1 0 0 0 0 1 0
0 1 0 1 1 0 1 0
0 0 0 0 1 0 1 0
1 1 1 0 0 1 1 0
0 0 4 0 1 0 1 1
0 1 1 1 0 0 0 1
3 0 0 1 0 1 0 1
0 1 0 0 0 1 0 0
