4
Box4.sob
Goal.sob
Door.SOB
Switch.SOB


8 1 8

0 0 1 0 0 1 0 0
1 0 1 0 1 1 1 3
0 0 0 0 0 0 0 0
1 1 1 1 0 1 1 1
0 0 60 0 0 0 0 0
1 0 1 0 1 1 0 1
0 0 1 0 4 0 0 0
1 0 1 0 0 1 0 1


