5
Box4.sob
Goal.sob
Door.SOB
Switch.SOB
Unstable_Wall.SOB


8 8

0 1 1 1 0 0 0 1
1 0 1 0 0 0 1 0
1 0 1 0 0 3 0 1
0 0 0 1 0 0 0 1
0 0 1 0 1 0 0 0
1 0 0 0 0 1 0 0
0 0 0 1 0 0 0 1
0 1 0 1 1 0 1 1


