3
Box5.sob
Goal.sob
Door.SOB

8 1 8

0 1 1 1 0 0 0 1
0 1 1 0 0 0 1 0
1 0 1 0 0 3 0 1
0 0 0 1 0 0 0 1
0 1 1 0 1 0 0 0
1 0 1 0 0 1 0 0
0 0 0 1 0 0 0 1
0 1 0 1 1 0 1 1


