3
Box4.sob
Goal.sob
Door.SOB


8 8

0 1 0 0 1 0 0 1
0 0 1 -2 0 1 0 0
1 0 1 1 0 0 1 0
0 0 0 0 1 0 0 1
0 1 0 1 1 1 0 0
0 0 1 0 0 0 1 0
0 0 0 1 0 0 0 3
1 0 0 1 0 1 0 1