3
Box1.sob
Box2.sob
Box3.sob
8 1 8

1 0 0 0 1 1 0 1
0 1 1 0 0 0 0 1
0 0 0 0 1 1 0 0
1 0 1 0 0 0 0 1
0 1 0 0 1 0 1 0
0 0 0 1 0 0 0 0 
0 0 1 0 0 0 0 1
1 1 1 0 0 1 0 1