2
Box4.sob
Goal.sob

8 8

0 1 0 0 1 0 0 1
0 0 1 -2 0 1 0 0
1 0 1 1 0 0 1 0
0 0 0 0 1 0 0 1
0 1 0 1 1 1 0 0
0 0 1 0 0 0 1 0
0 0 0 1 0 0 0 0
1 0 0 1 0 1 0 1